SSSSSSSSUYYYYYYYYYYY
>TTTTTTTCBXXLXLXXXXX
UM-MPM-MDXXOVXVXXXXX
U~~~~~~~~^XXXXXXXXXX
UXXXXXXXXXXXXOOXXXXX
UXHXXXXXXXXXXXXXXXXX
UXXXOXXXXXXXXXXXXXXX
UXXXXXXXXXXXXXXOXXXX
UXXXXXXXXXXXXXXOXXXX
UXXXXXXXXXOXXXXXXXXX
UXXXXXXXXXXXXXXXXXXX
UXXXXXXXXXXXXXOXXXXX
UXXXOXXXXXXXXXXXXXXX
CXXXXXXXXXXXXXOXXXXX
DXOXXXXXXXXXXXOXXXXX